Anschließend arbeitete er am Kunstmuseum Bonn und war von eintausendneunhundertdreiundneunzig bis zweitausend als wissenschaftlicher Mitarbeiter und Assistent der Direktion am Kunstmuseum Basel tätig.	200
Windows-Bitmaps erlauben Farbtiefen von 1, 4, 8, 16, vierundzwanzig oder zweiunddreißig bpp , wobei bei sechzehn und zweiunddreißig bpp nicht alle Bits tatsächlich genutzt werden müssen.	186
Hierzu wird ein Booster benötigt, der über 2,9 Sekunden einen zusätzlichen Schub von dreiundfünfzig kN liefert.	111
Der Rechtsanspruch darauf ist in § achtundzwanzig Abs. 3 SGB V gesetzlich verankert.	29
Während der Rückrunde der Saison 2006/07 wurde er in einem weiteren Leihgeschäft an Macclesfield Town abgegeben.	112
043 BRT große Dampfturbinenschiff Oronsay wurde auf der Werft John Brown & Company in Clydebank bei Glasgow gebaut.	115
Das 200,83 Meter lange und 22,86 Meter breite Schiff hatte zwei Schornsteine, zwei Masten und zwei Propeller.	109
Es wurde von zwei Dampfturbinen angetrieben, die dreitausendachthundertelf nominale PS leisteten und eine Geschwindigkeit von achtzehn Knoten ermöglichten.	155
000 BRT maßen und in der zweiten Hälfte der 1920er in Dienst gestellt wurden.	77
Das Postgebäude am Antonsplatz in Dresden war ein 1830–1832 erbautes Postdienstgebäude, das mehrfach durch Anbau und Aufstockung verändert wurde.	145
Er ersetzt einen in den 1950er Jahren als freistehende Stahlfachwerkkonstruktion ausgeführten Sendeturm und überträgt unter anderem Fernseh- und Radioprogramme.	160
Sie ist etwa 1,6 km lang und bis zu dreihundert m breit.	56
Seine persönliche Bestzeit von 1:49,2 min stellte er eintausendneunhundertachtundfünfzig auf.	93
Die Baukosten in Höhe von 7,2 Millionen Mark wurden zu achtzig vom Reich bezahlt, die restlichen zwanzig von Preußen getragen.	126
Der Schmuckstein wiegt einhundert g und hat fünfhundert Karat.	62
Geschützt durch die Alpenbarriere weist die Region eine sehr hohe Anzahl an Sonnenstunden und Sommermittel von über zwanzig °C auf.	131
Am bekanntesten wurde er durch The Spanish Farm Trilogy, 1914–1918, die als Trilogie erstmals eintausendneunhundertsiebenundzwanzig gesammelt erschien und aus den Einzelbänden The Spanish Farm , Sixty-four, Ninety-four!	219
Bei Ebbe ist sie über den vierhundert m langen Ardley-Isthmus mit der Fildes-Halbinsel verbunden.	97
Etwa 1,5 km nordwestlich von Drumoak liegt Drum Castle.	55
Die A93 verläuft durch Drumoak und schließt die Ortschaft an das Fernstraßennetz an.	84
Er liegt etwa vier km östlich des bebauten Stadtgebietes.	57
Das Bansmeer ist ca.	20
Von der Großstadt Corona ist der Berg 17,6 Kilometer entfernt.	62
€ an die katarische Beteiligungsgesellschaft Mayhoola for InvestmentsOktober 2014: Verkauf der zweitausendacht erworbenen Arysta LifeScience für 3,5 Mrd.	156
Das Stück ist ein 32-taktiger Walzer, der in der Liedform ABAC verfasst wurde.	78
Der Stein hat eine Höhe von einhundertfünfundachtzig cm, eine Breite zwischen fünfundvierzig und siebenundfünfzig cm und eine Tiefe zwischen zwanzig und fünfundzwanzig cm.	171
Sie erstreckt sich über eine Länge von 2,5 km im südlichen Teil des Wilhelm-Archipels und liegt 1,5 km nordwestlich des Kap Tuxen.	130
Im Zweiten Weltkrieg wurde der Flugplatz unter der Bezeichnung Hamraiet Airfield von der 57th Fighter Group der US-Luftwaffe genutzt.	133
Die Ortsmissweisung beträgt 2° Ost.	35
Epsilon Aquilae ist ein Roter Riese der Spektralklasse K1 und besitzt eine scheinbare Helligkeit von 4,0 mag.	109
In einer Distanz von nur etwa 3,5 AE dürfte ihn ein Begleiter unbekannten Typs in eintausendzweihundertsiebzig Tagen umrunden.	126
Die eine Komponente ist ein leuchtschwacher Stern mit einer scheinbaren Helligkeit von +10,2 mag und steht 148,6 Bogensekunden oder etwa dreitausendsiebenhundert AE vom Zentralstern entfernt.	191
Kunstmuseum Kloster Unser Lieben Frauen, Magdeburg, zweitausendzehn ISBN 978-3-941057-07-4 Peter Weibel : Pittura, Immedia: Malerei in den 90er Jahren.	151
Platz in der Klasse bis vierzig kg.	35
Es galt die 2-Punkte-Regel.	27
Letztere Bauart konnte auf dem Eis Geschwindigkeiten von bis zu vierzig km/h erreichen.	87
Von hier aus brechen sie häufig auf, um in andere Länder/Regionen Europas auszuwandern.	87
Die Vorderrad-Aufhängung des F2004 wurde komplett neu entwickelt.	65
Beim Vorjahresmodell, dem F2003-GA, gelang es nur selten die Reifen auf die richtige Betriebstemperatur zu bringen.	115
Etwa 1,1 km südwestlich liegt der Burro Pass.	45
der Verein gewann da Match mit 1:0 Toren.
13/003 in die Denkmalliste der Stadt Düren eingetragen.	55
Die Spieldauer beträgt je nach Fassung/Bearbeitung zwischen zwei ½ und drei ½ Stunden.	86
Die zweite belgische Fußballliga blickt auf eine mehr als 100-jährige Tradition zurück.	87
Nachdem der Leichte Kreuzer, der die gegnerischen Schiffe wenige Minuten zuvor gesichtet hatte, um 8:29 Uhr das Feuer eröffnet hatte, drehten die italienischen Kreuzer sogleich nach Südwesten ab.	195
Sie ist schätzungsweise zweihundertsieben Mio.	46
Zu dieser Zeit war die bekannte und in den Berechnungen berücksichtigte Beschleunigung durch den Strahlungsdruck der Sonne auf etwa vier · 10−10 m/s² gesunken.	159
552 Einwohnern und einer Fläche von 470,5 km² liegt die Stadt ca. dreißig km entfernt von Berlin.	65
Alle Vermessungsschiffe haben einen 7-t-Kran und werden auch als Tonnenleger eingesetzt.	88
Die geografischen Koordinaten sind 43°41′55″ nördlicher Breite und 95°28′07″ westlicher Länge.	94
Die Ikone, 35,7 × 25,7 cm groß, zeigt, auf Goldgrund, Maria in einem tiefblauen Gewand mit goldenen Bordüren, das als Schleier auch das Haar bedeckt.	149
In frühen amerikanischen Farbfernsehgeräten mit 21-Zoll-Bildröhre wurde eine Hochspannung von zwanzig kV bei einem maximalen Strom von ca.	138
550 mm , bei einer deutlichen Trockenzeit von April bis Oktober mit weniger als zwanzig mm Monatsniederschlag, und einer kurzen Feuchtezeit im Januar und Februar mit Niederschlägen deutlich über einhundert mm.	209
Dort schloss er sich 17-jährig der Jugendmannschaft des Club Nacional an.	73
Das Stadtgebiet hat eine Größe von 105,6 Quadratkilometern.	59
Häufig handelt es sich dabei um graue Literatur, also Forschungsberichte, Tagungsberichte, Abschlussarbeiten usw.	113
Die Ermittlung der Gewinner erfolgt mit Messmitteln bzw. Messgeräten.	5
es werden 1000 t/h erreicht.	17
Bald darauf, bei Kilometer 12,3/11,4 bei Molln kreuzt der Weg die Mollner Landesstraße, östlich in etwa 1,5 km Entfernung befindet sich das Nationalpark-Zentrum Molln.	167
Die Blütenstiele sind drei bis fünfundzwanzig mm lang, weiterwachsend, manchmal zurückgebogen.	94
921 ha großer Provincial Park im äußersten Südosten der kanadischen Provinz British Columbia.	93
In der Messtechnik wird zum Aufnehmen des Phasengang üblicherweise ein kontinuierliches Sinussignal verwendet, was dazu führt, dass Phasenverschiebungen nur im Bereich von ±180° bzw.	182
April zweitausendelf erzielte Kabasele beim 2:1-Auswärtssieg gegen den Lierse SK sein erstes Tor im Profifußball.	113
November zweitausendsechzehn beim 1:1-Unentschieden gegen Figueirense FC wurde er über die gesamte Spielzeit eingesetzt.	120
Der System-on-a-Chip ist ein mit 2,5 GHz getakteter Snapdragon achthunderteins mit vier Kernen vom Hersteller Qualcomm, bestehend aus einem Krait-400-Prozessor und einer Adreno-330-Grafikeinheit.	195
August zweitausendsieben auf 3+ ausgestrahlt.	45
Der mit etwa fünf Millionen US-Dollar budgetierte Film lockte etwa 1,6 Mio.	Zuschauer in die heimischen Kinos.	34
Wärmster Monat ist Juli mit 21,8 °C, während im Januar die Temperatur bei –3,3 °C liegt.	88
Das Ende der Entwicklung stellte Lucifer IV dar, der ab eintausendneunhundertfünfundzwanzig geliefert wurde und dessen Leistung auf einhundertvierzig PS gesteigert war.	168
Die oral letale Dosis beträgt für Mäuse zweihundertzwanzig mg.	76
Die Verkehrsdaten sind eine Unterkategorie der sog.	Randdaten, die bei der Nutzung jeglicher elektronischer Infrastruktur anfallen.
Der Hauptsaal hatte eine Grundfläche von fünfundvierzig m × dreiundzwanzig m und war dreiundzwanzig m hoch.	107
Natriumchlorid ist aus den Kationen Na+ und Anionen Cl− aufgebaut.	66
Das Salz Calciumchlorid wird von Ca2+ und Cl− gebildet.	55
Sie sind nach den §§ 28, zweiundzwanzig des Hessischen Gesetzes über Naturschutz und Landschaftspflege sowie $ zwölf des Hessischen Ausführungsgesetzes zum Bundesnaturschutzgesetz geschützt.	190
Sowohl beim 7:2-Hinspielerfolg als auch beim 5:2-Sieg im Rückspiel konnte Nielsen ein Tor beisteuern.	101
Unter anderem hierdurch verbraucht das leer zweitausendzweihundertsiebzig Kilogramm schwere Fahrzeug 11,8 lh bei gedrosseltem Motor.	132
Fritz Knapp ; † eintausendneunhundertachtunddreißig in Würzburg war ein deutscher Kunsthistoriker.	98
Ein # nennt sich Hashtag und ist ein Schlagwort zum auffinden von Informationen.
Der RC-Pilot benötigt für Schwebe- oder Steigflug ca. ≥ 5° Anstellwinkelfür einen Sinkflug < 5°für ein Autorotationsmanöver ca. –4° im Sinkflug und ca.	+10° in der Abfang/Landephase,um das Modell entsprechend zu bewegen.	68
Organisatorisch sind sie in einem Teilsachbereich im Referat Org. - Technischer Parlamentsdienst der Abteilung Z in der Bundestagsverwaltung angesiedelt.	87
E1 selbst besteht aus zwei α- und zwei β-Untereinheiten.	56
Von α gibt es beim Menschen eine zweite Isoform, die speziell in den Hoden exprimiert wird.	91
Mutationen in den Genen, die für α und β kodieren , können PDHE1-Mangel bis hin zum Leigh-Syndrom und Laktatazidose verursachen.	128
Als Dritter des Dublin-Marathons zweitausendneun erzielte er mit 2:11:14 h seine persönliche Bestzeit.	102
Die Schäden beliefen sich dabei auf mindestens eine Million DM, und der Betrieb musste für mehrere Wochen stillgelegt werden.	125
Der Preis von 1000 £ war nach der Weltmeisterschaft die zweithöchste der gesamten Tour.	72
Heute leben achtundvierzig % der Bevölkerung in Städten.	54
Es verfügte über zwei Dieselmotoren, die über Wasser eine Geschwindigkeit von siebzehn kn ermöglichten.	103